*X*************
*X*XXXXX*XXXXXX
*X*X***X***X***
*X*X*X*XXX*X*X*
*X***X***X***X*
*XXXXXXX*XXXXX*
*****X***X***X*
XXXX*X*XXX*X*X*
*****X*****X*X*
*XXXXXXXXXXXXX*
*X***********X*
*X*XXXXXXXXX*X*
*X***X*****X*X*
*XXX*X*XXXXX*X*
*****X*********