***********
XX*X*XXX*X*
***X*X*****
*XXX*XXXXXX
***X*X*****
XX*X*X*XXX*
***X*****X*
*XXXXXXXXX*
*X*********
*XXX*XXXXX*
*****X*****