***X*******
XX*X*XXX*XX
***X***X***
*XXX*XXXXX*
*X*X*X*****
*X*X*X*XXX*
*X*X*X*X***
*X*X*X*X*XX
*X***X*X***
*XXXXX*XXX*
*******X***